Legend:
G - grass
C - canyon
D - desert
L - flower
R - forest
W - water
M - mountain
! - castle
0 - location place

Quadrant 00:
----------
CDDDDDDDDD
CCCDDDDDCD
MMMDMM0DDC
CMMMMMLLCC
CCCMMWLLLC
GCCCMLLWRC
GG0RLLWLLR
GGRRLLG!RR
GGGRRWGGRR
GGGRWGGRRR

Quadrant 01:
----------
DDCWWRRRGG
D!CWRRR0GG
CCCLLLRCLL
CCLLWDDCCL
CGGWLLDDCC
GG0LWLWDDC
GGGRLLWWDD
GGRRMWWWDW
GMRRWWWWWW
RRRWWWWWWW

Quadrant 02:
----------
GGGRRWGRRR
GGG!RWGRRR
GLLGRRWGGR
LLCGRWL0RR
LLLCCWLLWW
MMCGGWWWDD
CCCMGLLLDD
CC!DMDLLCC
WWWDDDDMCC
WWWWDDDDDC

Quadrant 03:
----------
GGRRRWGRRL
GLRRWGRRLL
GLLRWGGLLL
LLRRWGMLDD
CL!RWGDDDD
CCRWGGMMDD
CCWWWGDDDC
WWGGWW0CMC
WD!GWMWCCC
WDDWWWWCCC

Quadrant 04:
----------
RRRRMMGMCC
RMRRLGMMMC
LLRLLLGGWM
DLLLW0GWMM
DDDDLWGWCC
DCDDDWWCGC
DDCDDWL!GC
CC0DWLLLGG
DCWWWRRLGG
DCCWRRRGGG

Quadrant 05:
----------
DDCWWRRGGG
DCWLLRRRGG
DDWLLRR0LG
WWWLGRLLLL
WWWWGGGGLL
WRRWGGCCDC
WRCRWGCCDC
W!CLW0DDCW
WWCLWWWDDW
WWWWWWWWWW

Quadrant 06:
----------
CCCDDWDDDD
MMCDDWDDDD
MMCMMWDD0L
MCMMWMDLLL
CCRRWMMCLL
CRRWCCCMLL
C0RRWLLLLL
GGRWG!GLGR
GGRRWGGGGR
GGRRWGGGRR

Quadrant 07:
----------
LDDMMDDCCC
LLDDDMMCCC
LLLLLLLMMM
WWL!GGRRMM
LLWWGGGRRC
LCCWGRRCCC
DL0CWRR0CG
DDCWRRGGGG
DDDWRRRGGG
DDWWRRRGGG

Quadrant 08:
----------
WWGGWWWLLL
WGGRWWWLLL
WWWGRWWDDL
RRW!RWDMLL
RRRWWWDDGG
RRRRCDGGGG
RR0CCCGGMG
RCCCCG0DDG
CMCCCLLLDD
CCCLLLLDDD

Quadrant 09:
----------
GGGWWWMCCC
GGWRDWWWCC
GMWR0DDDWM
LWRRCCDLLL
LWGGCCDDML
LW!GCCD0LL
LLWGCCCLLL
DWGGC!RRLL
DDWWGRRMRR
DDDWWRMRRR

Quadrant 10:
----------
CCCWWWWDDD
CCCW0LDDMD
CCCCCCLDMD
CGGCCMLMDD
CGGGDMMLLL
RLG0DDLLLL
RRLLDMLGGL
RRMLMR!GGG
RMRRRRWWGG
RRRRWWWGGG

Quadrant 11:
----------
DDDDDDDGGG
DDDMDLLLGG
DMDDDLWLGR
CLWD!WLRRR
CLLWWWL0CR
CLLLWWLCCC
CCC0RWWLMC
GCGGRWLCCC
GGGGRRRRCM
GGGRRRRRMM

